2 13 31
###############################
#   s  ** *  1 *   *  * h *   #
# # #b#*# # #*#*# # # #*#*#*# #
#32 *    *s* x *  1   *  9* * #
# # # # # #*# # #*#p# # # # #*#
#f   h 5     **  *  *    6    #
# # # # # # # # # #*# #*# # # #
#*  *      *  *   7  *   8    #
# # # #     # # #*#b# # # # # #
#*    *h  *                   #
# #*# # # # # # #*# # # # # # #
#           s   *  *      24  #
###############################



//
s : speed up
b : more bomb
h : more lives
p : flame up

