3 13 31
###############################
#   s  ** *  1 *   *  * h *   #
# # #b#*# # #*#*# # # #*#*#*# #
#32 *    *s* x *  1   *  9* * #
# # # # # #*# # #*#p# # # # #*#
#f   h 5    **  *  *          #
# # # # # # # # # #*# #*# # # #
#*  *      *  *   7  *        #
# # # #     # # #*#b# # # # # #
#*    *h  *    7              #
# #*# # # # # # #*# # # # # # #
#           s   *  *    1 24  #
###############################